+-+-+-+-+
|   | | |
+-+ + + +
| | |   |
+ + + + +
|   | | |
+ + + + +
| | | | |
+-+ + + +
|     | |
+-+-+-+-+
