+-+-+-+-+-+-+-+-+-+-+-+
| |   | |       |   | |
+ + +-+ + + + + +-+ + +
| |   | | | | | |     |
+ + +-+ +-+ +-+-+ +-+ +
| |     | |   |   |   |
+ + + + + +-+ +-+ +-+-+
|   | |     |     | | |
+-+-+ + +-+-+ + +-+ + +
| | | | |   | |       |
+ + + + +-+ + + + +-+-+
|     |       | |     |
+-+ +-+-+-+-+ + +-+ + +
|   | |     | |   | | |
+ + + +-+ +-+-+-+ +-+ +
| | | |   |       |   |
+-+ + +-+ + + +-+ + +-+
|   | |     |   | | | |
+-+ + + +-+ + +-+ + + +
|   |     | | | | |   |
+ +-+-+-+-+ + + +-+ + +
|           |     | | |
+-+-+-+-+-+-+-+-+-+-+-+
