+-+-+-+-+-+
| |   |   |
+ +-+ + +-+
|   |     |
+ +-+ +-+-+
|   | |   |
+-+ + +-+ +
|         |
+-+-+ + +-+
|     | | |
+ +-+ + + +
|   | |   |
+-+-+-+-+-+
