+-+-+-+-+
|   | | |
+-+ + + +
|     | |
+-+-+ + +
|       |
+ + + +-+
| | |   |
+-+-+ + +
| | | | |
+ + +-+ +
| | | | |
+ + + + +
|       |
+-+-+-+-+
