+-+-+-+-+-+-+-+-+-+-+-+-+-+-+-+
|   |                     | | |
+ + +-+ + + +-+-+-+-+ + +-+ + +
| | |   | | | | | |   | |     |
+ + +-+-+-+ + + + + +-+-+-+ +-+
| | |   |   |         | |   | |
+ + + +-+ +-+-+-+-+-+ + + + + +
| | | |             | | | |   |
+ +-+ +-+ +-+ + + +-+-+ + + +-+
| | | | |   | | |   | | | |   |
+ + + + +-+-+-+-+-+ + + + + + +
| | | |         |         | | |
+ + + + +-+-+-+-+-+ +-+ +-+ +-+
| |         |   |   | |   | | |
+ + + + +-+-+ + +-+ + + + +-+ +
| | | |     | | | |     |   | |
+ + + +-+-+-+-+ + +-+-+ +-+-+ +
|   |   |       | | | |       |
+-+-+-+ + +-+ + + + + + + + +-+
|       |   | | | |     | | | |
+-+ + + + +-+ + + + + + +-+-+ +
| | | |   | | |     | |   |   |
+ + +-+ + + +-+ +-+ + +-+-+ + +
| | | | |   | |   | |   | | | |
+ + + + +-+-+ +-+ + +-+ + +-+ +
| |   |         | | |       | |
+ + + + +-+ +-+-+-+ + +-+-+-+ +
|   | |   | |       | |   |   |
+ +-+-+ + + + +-+-+ + + +-+-+ +
|     | | | |     | |         |
+-+-+-+-+-+-+-+-+-+-+-+-+-+-+-+
